/	geekshop.views.index	index
/__debug__/render_panel/	debug_toolbar.views.render_panel	djdt:render_panel
/__debug__/sql_explain/	debug_toolbar.panels.sql.views.sql_explain	djdt:sql_explain
/__debug__/sql_profile/	debug_toolbar.panels.sql.views.sql_profile	djdt:sql_profile
/__debug__/sql_select/	debug_toolbar.panels.sql.views.sql_select	djdt:sql_select
/__debug__/template_source/	debug_toolbar.panels.templates.views.template_source	djdt:template_source
/admin/	django.contrib.admin.sites.index	admin:index
/admin/<app_label>/	django.contrib.admin.sites.app_index	admin:app_list
/admin/<url>	django.contrib.admin.sites.catch_all_view
/admin/auth/group/	django.contrib.admin.options.changelist_view	admin:auth_group_changelist
/admin/auth/group/<path:object_id>/	django.views.generic.base.RedirectView
/admin/auth/group/<path:object_id>/change/	django.contrib.admin.options.change_view	admin:auth_group_change
/admin/auth/group/<path:object_id>/delete/	django.contrib.admin.options.delete_view	admin:auth_group_delete
/admin/auth/group/<path:object_id>/history/	django.contrib.admin.options.history_view	admin:auth_group_history
/admin/auth/group/add/	django.contrib.admin.options.add_view	admin:auth_group_add
/admin/authnapp/shopuser/	django.contrib.admin.options.changelist_view	admin:authnapp_shopuser_changelist
/admin/authnapp/shopuser/<path:object_id>/	django.views.generic.base.RedirectView
/admin/authnapp/shopuser/<path:object_id>/change/	django.contrib.admin.options.change_view	admin:authnapp_shopuser_change
/admin/authnapp/shopuser/<path:object_id>/delete/	django.contrib.admin.options.delete_view	admin:authnapp_shopuser_delete
/admin/authnapp/shopuser/<path:object_id>/history/	django.contrib.admin.options.history_view	admin:authnapp_shopuser_history
/admin/authnapp/shopuser/add/	django.contrib.admin.options.add_view	admin:authnapp_shopuser_add
/admin/authnapp/shopuserprofile/	django.contrib.admin.options.changelist_view	admin:authnapp_shopuserprofile_changelist
/admin/authnapp/shopuserprofile/<path:object_id>/	django.views.generic.base.RedirectView
/admin/authnapp/shopuserprofile/<path:object_id>/change/	django.contrib.admin.options.change_view	admin:authnapp_shopuserprofile_change
/admin/authnapp/shopuserprofile/<path:object_id>/delete/	django.contrib.admin.options.delete_view	admin:authnapp_shopuserprofile_delete
/admin/authnapp/shopuserprofile/<path:object_id>/history/	django.contrib.admin.options.history_view	admin:authnapp_shopuserprofile_history
/admin/authnapp/shopuserprofile/add/	django.contrib.admin.options.add_view	admin:authnapp_shopuserprofile_add
/admin/autocomplete/	django.contrib.admin.sites.autocomplete_view	admin:autocomplete
/admin/jsi18n/	django.contrib.admin.sites.i18n_javascript	admin:jsi18n
/admin/login/	django.contrib.admin.sites.login	admin:login
/admin/logout/	django.contrib.admin.sites.logout	admin:logout
/admin/mainapp/author/	django.contrib.admin.options.changelist_view	admin:mainapp_author_changelist
/admin/mainapp/author/<path:object_id>/	django.views.generic.base.RedirectView
/admin/mainapp/author/<path:object_id>/change/	django.contrib.admin.options.change_view	admin:mainapp_author_change
/admin/mainapp/author/<path:object_id>/delete/	django.contrib.admin.options.delete_view	admin:mainapp_author_delete
/admin/mainapp/author/<path:object_id>/history/	django.contrib.admin.options.history_view	admin:mainapp_author_history
/admin/mainapp/author/add/	django.contrib.admin.options.add_view	admin:mainapp_author_add
/admin/mainapp/book/	django.contrib.admin.options.changelist_view	admin:mainapp_book_changelist
/admin/mainapp/book/<path:object_id>/	django.views.generic.base.RedirectView
/admin/mainapp/book/<path:object_id>/change/	django.contrib.admin.options.change_view	admin:mainapp_book_change
/admin/mainapp/book/<path:object_id>/delete/	django.contrib.admin.options.delete_view	admin:mainapp_book_delete
/admin/mainapp/book/<path:object_id>/history/	django.contrib.admin.options.history_view	admin:mainapp_book_history
/admin/mainapp/book/add/	django.contrib.admin.options.add_view	admin:mainapp_book_add
/admin/mainapp/publisher/	django.contrib.admin.options.changelist_view	admin:mainapp_publisher_changelist
/admin/mainapp/publisher/<path:object_id>/	django.views.generic.base.RedirectView
/admin/mainapp/publisher/<path:object_id>/change/	django.contrib.admin.options.change_view	admin:mainapp_publisher_change
/admin/mainapp/publisher/<path:object_id>/delete/	django.contrib.admin.options.delete_view	admin:mainapp_publisher_delete
/admin/mainapp/publisher/<path:object_id>/history/	django.contrib.admin.options.history_view	admin:mainapp_publisher_history
/admin/mainapp/publisher/add/	django.contrib.admin.options.add_view	admin:mainapp_publisher_add
/admin/mainapp/specifications/	django.contrib.admin.options.changelist_view	admin:mainapp_specifications_changelist
/admin/mainapp/specifications/<path:object_id>/	django.views.generic.base.RedirectView
/admin/mainapp/specifications/<path:object_id>/change/	django.contrib.admin.options.change_view	admin:mainapp_specifications_change
/admin/mainapp/specifications/<path:object_id>/delete/	django.contrib.admin.options.delete_view	admin:mainapp_specifications_delete
/admin/mainapp/specifications/<path:object_id>/history/	django.contrib.admin.options.history_view	admin:mainapp_specifications_history
/admin/mainapp/specifications/add/	django.contrib.admin.options.add_view	admin:mainapp_specifications_add
/admin/mainapp/translator/	django.contrib.admin.options.changelist_view	admin:mainapp_translator_changelist
/admin/mainapp/translator/<path:object_id>/	django.views.generic.base.RedirectView
/admin/mainapp/translator/<path:object_id>/change/	django.contrib.admin.options.change_view	admin:mainapp_translator_change
/admin/mainapp/translator/<path:object_id>/delete/	django.contrib.admin.options.delete_view	admin:mainapp_translator_delete
/admin/mainapp/translator/<path:object_id>/history/	django.contrib.admin.options.history_view	admin:mainapp_translator_history
/admin/mainapp/translator/add/	django.contrib.admin.options.add_view	admin:mainapp_translator_add
/admin/password_change/	django.contrib.admin.sites.password_change	admin:password_change
/admin/password_change/done/	django.contrib.admin.sites.password_change_done	admin:password_change_done
/admin/r/<int:content_type_id>/<path:object_id>/	django.contrib.contenttypes.views.shortcut	admin:view_on_site
/admin/social_django/association/	django.contrib.admin.options.changelist_view	admin:social_django_association_changelist
/admin/social_django/association/<path:object_id>/	django.views.generic.base.RedirectView
/admin/social_django/association/<path:object_id>/change/	django.contrib.admin.options.change_view	admin:social_django_association_change
/admin/social_django/association/<path:object_id>/delete/	django.contrib.admin.options.delete_view	admin:social_django_association_delete
/admin/social_django/association/<path:object_id>/history/	django.contrib.admin.options.history_view	admin:social_django_association_history
/admin/social_django/association/add/	django.contrib.admin.options.add_view	admin:social_django_association_add
/admin/social_django/nonce/	django.contrib.admin.options.changelist_view	admin:social_django_nonce_changelist
/admin/social_django/nonce/<path:object_id>/	django.views.generic.base.RedirectView
/admin/social_django/nonce/<path:object_id>/change/	django.contrib.admin.options.change_view	admin:social_django_nonce_change
/admin/social_django/nonce/<path:object_id>/delete/	django.contrib.admin.options.delete_view	admin:social_django_nonce_delete
/admin/social_django/nonce/<path:object_id>/history/	django.contrib.admin.options.history_view	admin:social_django_nonce_history
/admin/social_django/nonce/add/	django.contrib.admin.options.add_view	admin:social_django_nonce_add
/admin/social_django/usersocialauth/	django.contrib.admin.options.changelist_view	admin:social_django_usersocialauth_changelist
/admin/social_django/usersocialauth/<path:object_id>/	django.views.generic.base.RedirectView
/admin/social_django/usersocialauth/<path:object_id>/change/	django.contrib.admin.options.change_view	admin:social_django_usersocialauth_change
/admin/social_django/usersocialauth/<path:object_id>/delete/	django.contrib.admin.options.delete_view	admin:social_django_usersocialauth_delete
/admin/social_django/usersocialauth/<path:object_id>/history/	django.contrib.admin.options.history_view	admin:social_django_usersocialauth_history
/admin/social_django/usersocialauth/add/	django.contrib.admin.options.add_view	admin:social_django_usersocialauth_add
/admin_staff/author/create/	adminapp.views.author.author_create	adminapp:author_create
/admin_staff/author/delete/<int:pk>/	adminapp.views.author.author_delete	adminapp:author_delete
/admin_staff/author/read/	adminapp.views.author.author	adminapp:author
/admin_staff/author/update/<int:pk>/	adminapp.views.author.author_update	adminapp:author_update
/admin_staff/book/create/	adminapp.views.book.book_create	adminapp:book_create
/admin_staff/book/delete/<int:pk>/	adminapp.views.book.book_delete	adminapp:book_delete
/admin_staff/book/read/	adminapp.views.book.book	adminapp:book
/admin_staff/book/update/<int:pk>/	adminapp.views.book.book_update	adminapp:book_update
/admin_staff/publisher/create/	adminapp.views.publisher.publisher_create	adminapp:publisher_create
/admin_staff/publisher/delete/<int:pk>/	adminapp.views.publisher.publisher_delete	adminapp:publisher_delete
/admin_staff/publisher/read/	adminapp.views.publisher.publisher	adminapp:publisher
/admin_staff/publisher/update/<int:pk>/	adminapp.views.publisher.publisher_update	adminapp:publisher_update
/admin_staff/specifications/create/	adminapp.views.specific.specifications_create	adminapp:specifications_create
/admin_staff/specifications/delete/<int:pk>/	adminapp.views.specific.specifications_delete	adminapp:specifications_delete
/admin_staff/specifications/read/	adminapp.views.specific.specifications	adminapp:specifications
/admin_staff/specifications/update/<int:pk>/	adminapp.views.specific.specifications_update	adminapp:specifications_update
/admin_staff/translator/create/	adminapp.views.translator.translator_create	adminapp:translator_create
/admin_staff/translator/delete/<int:pk>/	adminapp.views.translator.translator_delete	adminapp:translator_delete
/admin_staff/translator/read/	adminapp.views.translator.translator	adminapp:translator
/admin_staff/translator/update/<int:pk>/	adminapp.views.translator.translator_update	adminapp:translator_update
/admin_staff/users/create/	adminapp.views.user.UserCreateView	adminapp:user_create
/admin_staff/users/delete/<int:pk>/	adminapp.views.user.UserDeleteView	adminapp:user_delete
/admin_staff/users/read/	adminapp.views.user.UsersListView	adminapp:users
/admin_staff/users/update/<int:pk>/	adminapp.views.user.UserUpdateView	adminapp:user_update
/auth/edit/	authnapp.views.edit	authnapp:edit
/auth/login/	authnapp.views.login	authnapp:login
/auth/logout/	authnapp.views.logout	authnapp:logout
/auth/register/	authnapp.views.register	authnapp:register
/auth/verify/<str:email>/<str:activation_key>/	authnapp.views.verify	authnapp:verify
/basket/	basket.views.basket	basket:view
/basket/add/<int:pk>/	basket.views.basket_add	basket:add
/basket/edit/<int:pk>/<int:quantity>/	basket.views.basket_edit	basket:edit
/basket/remove/<int:pk>/	basket.views.basket_remove	basket:remove
/catalog/	mainapp.views.catalog	products:catalog
/catalog/book/<int:id>/	mainapp.views.products	products:book
/complete/<backend>/	social_django.views.complete	social:complete
/contacts/	geekshop.views.contacts	contacts
/disconnect/<backend>/	social_django.views.disconnect	social:disconnect
/disconnect/<backend>/<association_id>/	social_django.views.disconnect	social:disconnect_individual
/login/<backend>/	social_django.views.auth	social:begin
/media/<path>	django.views.static.serve
/order/	ordersapp.views.OrderList	order:orders_list
/order/create/	ordersapp.views.OrderCreate	order:order_create
/order/delete/<int:pk>/	ordersapp.views.OrderDelete	order:order_delete
/order/forming/complete/<int:pk>/	ordersapp.views.order_forming_complete	order:order_forming_complete
/order/product/<int:pk>/price/	ordersapp.views.get_product_price
/order/read/<int:pk>/	ordersapp.views.OrderRead	order:order_read
/order/update/<int:pk>/	ordersapp.views.OrderUpdate	order:order_update
/static/<path>	django.views.static.serve
